3
m m m m m m m m m m m m m m m m m m m m m m m m m m m m m m m m m m m m
m i 9 8 7 m 9 8 7 0 5 0 1 0 5 0 1 0 5 0 1 0 5 0 1 0 5 0 1 0 5 0 1 0 5 m
m 6 0 m 4 0 9 8 7 0 0 0 0 0 0 0 9 9 9 9 4 4 4 4 4 3 3 3 3 3 3 3 3 3 3 m
m m 3 m 2 m 9 8 7 p 0 0 0 0 0 0 0 9 9 9 9 4 4 4 4 4 3 3 3 3 3 3 3 3 3 m
m 1 0 5 0 1 9 8 7 5 5 5 5 5 5 5 5 5 5 5 5 5 5 5 5 5 5 5 5 5 5 5 5 5 5 m
m m m m m m 0 0 0 0 0 0 0 0 0 0 9 9 9 9 4 4 4 4 4 3 3 3 3 3 3 3 3 3 3 m
m 1 0 5 0 1 9 8 7 m m m m m m m m m m 8 m m m m m m m 8 m m m m m m m m
m 1 0 5 0 1 9 8 7 8 5 5 5 5 5 5 5 5 5 5 5 5 5 5 5 5 5 5 6 6 6 6 6 6 0 m
m 1 0 5 0 1 9 8 7 8 5 5 5 5 5 5 5 5 6 6 6 6 6 6 1 1 1 1 1 1 1 1 1 1 1 m
m 1 0 5 0 1 9 8 7 0 6 6 6 6 6 6 m m m m m m m m m m m m m m m 9 9 9 9 m
m 1 0 5 0 1 9 8 7 0 m m m m m 0 0 0 0 0 1 1 1 1 1 1 1 1 1 1 1 1 1 1 1 m
m 1 0 5 0 1 9 8 7 0 8 8 8 8 8 8 8 8 8 m m m m m m m m m m m 8 8 m m m m
m 1 0 5 0 1 9 8 7 0 5 5 5 5 5 5 5 5 6 6 6 6 6 6 1 1 1 1 1 1 1 1 1 1 1 m
m 1 0 5 0 1 9 8 7 0 5 5 5 5 5 5 5 5 6 6 6 6 6 6 1 1 1 1 1 1 1 1 1 1 1 m
m 1 0 5 0 1 9 8 7 0 5 5 5 5 5 5 5 5 6 6 6 6 6 6 1 1 1 1 1 1 1 1 1 1 1 m
m 1 0 5 0 1 9 8 7 0 1 0 5 0 1 9 8 7 0 5 5 1 0 5 0 1 9 8 7 0 5 5 m m m m
m 1 0 5 0 1 9 8 7 m m m m m m m m m m m m m m m 1 0 5 0 1 9 8 7 0 5 5 m
m 1 0 5 0 1 9 8 7 8 1 0 5 0 1 9 8 7 m 5 5 1 0 5 0 1 9 8 7 0 5 5 m m m m
m 1 0 5 0 1 9 8 7 1 0 5 0 1 9 8 7 1 m 5 0 1 9 8 7 0 5 5 1 0 5 0 1 9 8 m
m 1 0 5 0 1 9 8 7 8 1 0 5 0 1 9 8 7 8 5 5 1 0 5 0 1 9 8 7 0 5 5 0 0 0 m
m 1 0 5 0 1 9 8 7 8 1 0 5 0 1 9 8 7 m 5 u 1 0 5 0 1 9 8 7 0 5 5 0 0 0 m
m 1 0 5 0 1 9 8 7 8 1 0 5 0 1 9 8 7 m 5 5 1 0 5 0 1 9 8 7 0 5 5 0 0 0 m
m m m m m m m m m m m m m m m m m m m m m m m m m m m m m m m m m m m m