5
mmmmmmmm
mm1mmm1m
mfm46u3m
m9m35mmm
m3m2m5mm
m24i34mm
mmmmmmmm